En cuanto al css de este ejercicio existen dos tipos de warnings, uno por la redefinicion del color de fondo, o el color de las letras.

Este warning aparece debido a que que se redefinen el color de fondo y de letra en un solo punto. No es necesario que se redefinan los colores en otros elementos , debido a que toman los colores deseados gracias la herencia en css.

En cuanto al acceso por teclado las siguientes teclas / combinaciones de teclas tendrán se asociaran a los siguientes operaciones.

- Teclas numericas 0-9: Estarán asociados los botones con dicho valor. Ej: 1 -> botón '1'.
- Teclas de operaciones (+,-,/,*): Estarán asociadas a sus respectivas operaciones.
- Tecla '%': Estará asociada a la operacion de porcentage.
- Tecla 'c': Estará asociada al boton 'c'
- Tecla 'e': Estará asociada al boton 'ce'
- Tecla 'm': Estará asociada al boton 'mrc'
- Tecla 'q': Estará asociada al boton '√'
- Tecla '.': Estará asociada al botón '.'
- Tecla '=': Estará asociada al boton '='
- Tecla '(': Estará asociada al boton '('
- Tecla ')': Estará asociada al boton ')'
- Tecla 'C': Estará asociada al boton 'MC'
- Tecla '^^': Estará asociada al boton 'x^y'
- Tecla 'Backspace': Estará asociada al botón 'Del'
- Tecla 'Control': Estará asociada al boton '2nd'
- Tecla 'r': Estará asociada al boton 'MR'
- Tecla 'p': Estará asociada al boton 'π'
- Tecla 's': Estará asociada al boton 'MS'
- Tecla 'o': Estará asociada al boton 'cos'
- Tecla 'i': Estará asociada al botón 'sin'
- Tecla 't': Estará asociada al boton 'tan'
- Tecla 'x': Estará asociada al boton 'exp'
- Tecla 'd': Estará asociada al boton 'mod'
- Tecla 'l': Estará asociada al boton 'log'
- Tecla 'f': Estará asociada al boton 'factorial'
- Tecla '^2': Estará asociada al boton 'x^2'
- Tecla '^x': Estará asociada al boton '10^x'
- Combinación Shift+'+': Estará asociada al boton 'M+'
- Combinación Shift+'-': Estará asociada al boton 'M-'
- Combinación Shift+'->' (flecha derecha): Estará asociada al botón '+/-'